25 20
#############
#...........#    ########
#...s...s...######......#
.@....sssss.............#
#...........######......#
#.....s.....#    #......#
#...........#    #......#
#...........#    #......#
#####..######    ###.####
    #..#           #.#
    #..#           #.#
    #..#           #.#
  ###..####        #.#
  #.......#        #s#
  #.......#        #.#
  #....1..#      ###.####
  #.......#      #.p...p#
  #..s....#      #....k.#
  #....S..#      #pS..p.#
  ####c####       ######